atom	Atom
atomref	AtomRef
atomid	AtomID
idpair	IDPair
SCbox	SCBox
SCboxed	SCBoxed
atomvec	AtomVec
Nvector	NVector
Numvector	NumVector
metagroup	MetaGroup
neighborlist	NeighborList
SCatomvec	SCAtomVec
coordConstraint	CoordConstraint
atomgroup	AtomGroup
subgroup	SubGroup
statetracker	StateTracker
interaction	Interaction
bondangle	BondAngle
dihedral	Dihedral
dihedralgrouping	DihedralGrouping
electricScreened	ElectricScreened
fixedForceAtom	FixedForceAtom
fixedForce	FixedForce
angletriples	AngleTriples
bondpairs	BondPairs
collection	Collection
collectionCDBD	CollectionCDBD
collectionCDBDgrid	CollectionCDBDgrid
collectionConjGradient	CollectionConjGradient
collectionConjGradientBox	CollectionConjGradientBox
collectionDamped	CollectionDamped
collectionGaussianT	CollectionGaussianT
collectionGear3A	CollectionGear3A
collectionGear4A	CollectionGear4A
collectionGear4NPH	CollectionGear4NPH
collectionGear4NPT	CollectionGear4NPT
collectionGear5A	CollectionGear5A
collectionGear6A	CollectionGear6A
collectionNLCG	CollectionNLCG
collectionNLCGV	CollectionNLCGV
collectionNoseHoover	CollectionNoseHoover
collectionOverdamped	CollectionOverdamped
collectionRK4	CollectionRK4
collectionSol	CollectionSol
collectionSolHT	CollectionSolHT
collectionVerlet	CollectionVerlet
collectionVerletNPT	CollectionVerletNPT
constraint	Constraint
coordCOMConstraint	CoordCOMConstraint
dihedrals	Dihedrals
distConstraint	DistConstraint
fixedForceRegion	FixedForceRegion
fixedSpring	FixedSpring
fpairxFunct	FPairXFunct
interactgroup	InteractGroup
interactionpairsx	InteractionPairsX
jamminglist	JammingList
jamminglistrot	JammingListRot
jammingtree	JammingTree
jammingtree2	JammingTree2
jammingtreeBD	JammingTreeBD
linearConstraint	LinearConstraint
pairlist	PairList
relativeConstraint	RelativeConstraint
xrpsummer	XRPSummer
anglegrouping	AngleGrouping
bondgrouping	BondGrouping
event	Event
fixedForceRegionAtom	FixedForceRegionAtom
fixedSpringAtom	FixedSpringAtom
forcepair	ForcePair
forcepairx	ForcePairX
